############################
#@ #...      #     .......E#
#  #E..#     #E....#O......#
#  #...#     #....E#O......#
#      #     #.....#O......#
#   ####.....E.....#O.....O#
#      #####################
#..#   #O...........#...E..#
#..#   #O...........#......#
#..#    ............O......#
############################