#####################
O....#.........#....O
####.#.#######.#.####
#.........#.........#
#.####.#..#..#.####.#
#.#....#.....#....#.#
#...##.#######.##...#
###..#.........#..###
#....#.### ###.#....#
#.##...### ###...##.#
#..#.#.#######.#.#..#
##.#.#.........#.#.##
 #.#.###.###.###.#.# 
 #.......###.......# 
##.#####.###.#####.##
O.....#.......#.....O
##.##.#.#####.#.##.##
#..##.....#.....##..#
#.###.###...###.###.#
#.........@.........#
#####################