########################
#......O...............#
#.####################.#
#.#..................#.#
#.#.##############O#.#.#
#.#.#.....OE.....O.#.#.#
#.#.#.##############.#.#
#@#.#................#.#
#O#.##################.#
#.#....................#
########################