###########
#.........#
##O########
#.........#
########O##
#@........#
###########