####################
#.....#............#
##.....#.....E.....#
#..........##......#
#.....###..........#
#......###....E....#
#...@.#............#
####################
