####################
#.@...#............#
##.....#.....E.....#
#..........##......#
#.....###..........#
#......###.........#
#..................#
####################
