##############
#.....@......#
#.##########.#
#.# Pl-man #.#
#.##########.#
#............#
##############