#######################
#..........E.......#..#
#..###############.#..#
#................#.#..#
#....###..###....#.#..#
#....#.@....#....#.#..#
#....#......#....#.#..#
#....#....E.#....#.#..#
#....###..###....#.#..#
#.....................#
#######################