####################
#@...#E...... .....#
#....# .....# .....#
#..... .....#E.....#
####################
