###############################
#E    ........E..........E    #
#......################.......#
#......O .............#.......#
#......#              #.......#
#......#   ###O####   #.......#
#......#   #.    .#   #.......#
#......#   O   @  O   #.......#
#......#   #.    .#   #.......#
#......##O##########O##.......#
#......#              #.......#
#......#      O       #.......#
#......################.......#
#O............E..............O#
###############################