####################
#..................#
#..####.....####...#
#..................#
#....###....E.#....#
#....#.@.##...#....#
#....#...##...#....#
#....##..####..##..#
#....##....##..##..#
#.....######...##..#
####################