#########################
#....O@.................#
####################....#
#O......................#
#########################