####################
#@....##..........O#
##.....##..........#
#..........##......#
#.....###..........#
#O##...###...###...#
#..#..#...........O#
####################
