########################
#..............#.......#
#....#.#.####.##.#####.#
#.######.#.........#.#.#
#.#....#.#.#.....#.#.#.#
#.#....#.#.#.....#.#.#O#
#.O....#.#.#####.#.#.#.#
#.#....#.#.#.....#...#.#
#.######.#.#.....#####.#
#...E....#....@...E....#
########################