############################
#    #E          #.........#
#    #E          O.   E   .#
#    O           #.........#
#    O           ###O#######
#    O     @     #....#....#
#    O           ########O##
#    O           #.........#
#    #           O.   E   .#
#O   #          E#.........#
############################