####################
#..........E.......#
#..####.....####...#
#.O................#
#....####@####.....#
#.##...........##..#
#.##...####....##..#
#..................#
####################