###########
#.........#
##.......##
###.....###
#####@#####
###.....###
##.......##
#.........#
###########