#######################################################
#E....................................................#
#.....................................................#
#.....................................................#
#.......................@.............................#
#.....................................................#
#.....................................................#
#.....................................................#
#.....................................................#
#######################################################
