#######################
#..........#..........#
#.###.####.#.###.####.#
#.###.####.#.###.####.#
#.....................#
#.###.#.#######.#.###.#
#.....#....#....#.....#
#####.#....#....#.#####
    #.####...####.#    
#####.#.........#.#####
O.....#.### ###.#.....O
#####.#.#  E  #.#.#####
    #...#######...#    
#####.#....@....#.#####
#.....#.#######.#.....#
#.###......#......###.#
#...#.####.#.####.#...#
###.#.............#.###
#.....#.#######.#.....#
#.#####....#....#####.#
#.....................#
#######################