#############
#..........E#
#.#.#.#.#.#.#
#@#.#O#.#.#.#
#############
