##############
#@...........#
############.#
#............#
##############
