##############
#............#
#@###E###E##E#
#............#
##############
