#############
#.....#.....#
#..@..#.....#
#O....# ....#
#############
