##############
#............#
#.    @     .#
#............#
##############
