##############
#O..........@#
##O###########
# ...........#
##############
