################
#    E         #
#@.............#
#         E    #
################
