##############
#............#
#@############
#............#
##############
