#######################
#..........O..........#
#.#.#.###########.#.#.#
#.#.#.O.........O.#.#.#
#.#.#.###########.#.#.#
#.....................#
#.#O####.## ##.####O#.#
#.#....#.## ##.#....#.#
#.####.#.#####.#.####.#
#....#.#.......#.#....#
####.#O#.#####.#O#.####
#........#   #........#
#.#.####.#####.####.#.#
#.#.# R#.# I #.#P #.#.#
#.#.####.#####.####.#.#
#....O.....@.....O....#
#######################