##########################
#O#  #...#...........E...#
#.#  #.#.###..##.######..#
#.#  ..#.#.......#.#..#..#
#.#  #.#...#.....#.#..#..#
#.#  #...#.#.@...#.#..#.O#
#.O  #.#.#.####..#.#..#..#
#.#  ..#...#....#..#..####
#.#  #.#.#.#....#..O..####
#.#  ..#..........E#.....#
##########################