##################
#.#v      O      #
#.O   @          #
#.#^         O  O#
##################