#############################
#. O                     O .#
#       KILL'eM ALL!        #
#            @              #
#   ######       ######     #
#        #       #          #
#     O  #   O   #  O       #
#        #       #          #
#   ######       ######     #
#                           #
# They've stolen your dots! #
#.           O             .#
#############################
